6	3	1	4	2	5	7	9	8
8	7	4	3	1	9	5	2	6
2	5	9	6	8	7	1	3	4
1	6	5	2	9	3	4	8	7
3	4	2	1	7	8	9	6	5
7	9	8	5	4	6	3	1	2
4	8	7	9	3	2	6	5	1
5	2	3	7	6	1	8	4	9
9	1	6	8	5	4	2	7	3
