5	1	3	2	6	4	7	9	8
7	6	4	8	1	9	2	3	5
2	9	8	7	3	5	1	4	6
1	4	6	3	7	2	8	5	9
3	8	2	5	9	6	4	7	1
9	5	7	1	4	8	6	2	3
4	7	1	9	8	3	5	6	2
6	3	5	4	2	1	9	8	7
8	2	9	6	5	7	3	1	4
