7	5	6	1	2	3	8	9	4
2	1	4	6	8	9	7	3	5
8	9	3	4	5	7	1	6	2
3	4	9	8	1	2	6	5	7
6	2	7	5	3	4	9	1	8
1	8	5	9	7	6	2	4	3
5	3	1	2	6	8	4	7	9
4	7	8	3	9	1	5	2	6
9	6	2	7	4	5	3	8	1
