5	3	2	1	4	7	8	9	6
6	1	8	2	5	9	3	7	4
4	7	9	6	8	3	5	2	1
3	4	6	5	2	8	9	1	7
2	9	5	7	1	4	6	8	3
1	8	7	9	3	6	4	5	2
9	2	1	3	6	5	7	4	8
8	5	3	4	7	2	1	6	9
7	6	4	8	9	1	2	3	5
