6	1	5	2	3	4	7	9	8
4	3	2	8	7	9	6	1	5
8	7	9	1	5	6	2	4	3
2	9	7	4	8	1	3	5	6
1	8	3	6	2	5	9	7	4
5	4	6	3	9	7	8	2	1
7	2	8	5	1	3	4	6	9
9	5	4	7	6	8	1	3	2
3	6	1	9	4	2	5	8	7
