1 4 7 2 5 3 9 6 8
2 3 8 4 6 9 1 7 5
6 9 5 7 8 1 2 3 4
4 5 6 1 3 8 7 2 9
3 7 9 6 2 4 5 8 1
8 1 2 5 9 7 3 4 6
9 2 3 8 1 6 4 5 7
5 6 4 9 7 2 8 1 3
7 8 1 3 4 5 6 9 2
