2	9	8	3	1	6	4	5	7
7	3	1	4	5	2	6	9	8
5	6	4	7	8	9	2	3	1
3	5	9	1	2	8	7	4	6
1	7	6	9	3	4	8	2	5
4	8	2	6	7	5	3	1	9
6	4	3	8	9	1	5	7	2
9	2	7	5	6	3	1	8	4
8	1	5	2	4	7	9	6	3
