8	5	4	1	2	7	3	6	9
6	1	3	8	4	9	2	7	5
7	9	2	3	6	5	1	4	8
2	3	5	4	1	8	7	9	6
4	8	9	2	7	6	5	1	3
1	6	7	5	9	3	4	8	2
5	4	8	6	3	1	9	2	7
3	7	1	9	8	2	6	5	4
9	2	6	7	5	4	8	3	1
