5	8	3	1	2	4	7	6	9
7	4	2	3	9	6	1	8	5
6	9	1	8	5	7	2	4	3
1	3	8	7	6	2	9	5	4
2	6	9	5	4	8	3	1	7
4	5	7	9	3	1	8	2	6
8	1	4	6	7	3	5	9	2
3	2	5	4	1	9	6	7	8
9	7	6	2	8	5	4	3	1
