2	6	3	1	4	7	5	9	8
7	4	8	2	5	9	6	1	3
9	5	1	8	3	6	2	4	7
3	2	7	6	1	4	9	8	5
1	8	5	7	9	2	4	3	6
4	9	6	3	8	5	7	2	1
5	3	2	9	7	8	1	6	4
6	1	4	5	2	3	8	7	9
8	7	9	4	6	1	3	5	2
